E00B001011
B000B10101
1B0B111101
10B0B11101
0101000101
01010B0001
01B11B0111
01B00B0B11
S001110B11
11100000B1